9 | . . P . . . . . . P
8 | . . X . . . . . . .
7 | . . X . . . . . . .
6 | . . X . . . . . . .
5 | . . X P X X X X X X
4 | . . X . . . . . . .
3 | . . X . . . . . . .
2 | . . X . . . . . . .
1 | . . X . . . . . . .
0 | R . X . . . . . . D
  +--------------------
    0 1 2 3 4 5 6 7 8 9
Imposible de simular actualmente ni por una TPU v5e1 de Google gastando 47GB de RAM y 44 minutos y 128.000.000 de Nodos con la heurística actual
